JURISDICTION NAME,COUNT PARTICIPANTS,COUNT FEMALE,PERCENT FEMALE,COUNT MALE,PERCENT MALE,COUNT GENDER UNKNOWN,PERCENT GENDER UNKNOWN,COUNT GENDER TOTAL,PERCENT GENDER TOTAL,COUNT NORTH INDIAN,PERCENT NORTH INDIAN,COUNT OTHER ETHNICITY,PERCENT OTHER ETHNICITY,COUNT ETHNICITY UNKNOWN,PERCENT ETHNICITY UNKNOWN,COUNT ETHNICITY TOTAL,PERCENT ETHNICITY TOTAL,COUNT PERMANENT RESIDENT ALIEN,PERCENT PERMANENT RESIDENT ALIEN,COUNT INDIA CITIZEN,PERCENT INDIA CITIZEN,COUNT OTHER CITIZEN STATUS,PERCENT OTHER CITIZEN STATUS,COUNT CITIZEN STATUS UNKNOWN,PERCENT CITIZEN STATUS UNKNOWN,COUNT CITIZEN STATUS TOTAL,PERCENT CITIZEN STATUS TOTAL,COUNT RECEIVES PUBLIC ASSISTANCE,PERCENT RECEIVES PUBLIC ASSISTANCE,COUNT NRECEIVES PUBLIC ASSISTANCE,PERCENT NRECEIVES PUBLIC ASSISTANCE,COUNT PUBLIC ASSISTANCE UNKNOWN,PERCENT PUBLIC ASSISTANCE UNKNOWN,COUNT PUBLIC ASSISTANCE TOTAL,PERCENT PUBLIC ASSISTANCE TOTAL
641043,44,22,0.5,22,0.5,0,0,44,100,0,0,3,0.07,0,0,44,100,2,0.05,42,0.95,0,0,0,0,44,100,20,0.45,24,0.55,0,0,44,100
620020,35,19,0.54,16,0.46,0,0,35,100,0,0,0,0,0,0,35,100,2,0.06,33,0.94,0,0,0,0,35,100,2,0.06,33,0.94,0,0,35,100
303101,1,1,1,0,0,0,0,1,100,0,0,0,0,0,0,1,100,0,0,1,1,0,0,0,0,1,100,0,0,1,1,0,0,1,100
457779,0,0,0,0,0,0,0,0,0,0,0,0,0,0,0,0,0,0,0,0,0,0,0,0,0,0,0,0,0,0,0,0,0,0,0
500107,2,2,1,0,0,0,0,2,100,0,0,0,0,0,0,2,100,1,0.5,1,0.5,0,0,0,0,2,100,0,0,2,1,0,0,2,100
422111,6,2,0.33,4,0.67,0,0,6,100,0,0,0,0,0,0,6,100,0,0,6,1,0,0,0,0,6,100,0,0,6,1,0,0,6,100
783124,1,0,0,1,1,0,0,1,100,0,0,0,0,0,0,1,100,0,0,1,1,0,0,0,0,1,100,1,1,0,0,0,0,1,100
440022,2,0,0,2,1,0,0,2,100,0,0,0,0,0,0,2,100,0,0,2,1,0,0,0,0,2,100,0,0,2,1,0,0,2,100
641043,0,0,0,0,0,0,0,0,0,0,0,0,0,0,0,0,0,0,0,0,0,0,0,0,0,0,0,0,0,0,0,0,0,0,0
620020,3,2,0.67,1,0.33,0,0,3,100,0,0,1,0.33,0,0,3,99,0,0,3,1,0,0,0,0,3,100,0,0,3,1,0,0,3,100
303101,0,0,0,0,0,0,0,0,0,0,0,0,0,0,0,0,0,0,0,0,0,0,0,0,0,0,0,0,0,0,0,0,0,0,0
457779,8,1,0.13,7,0.88,0,0,8,100,0,0,0,0,0,0,8,100,0,0,8,1,0,0,0,0,8,100,1,0.13,7,0.88,0,0,8,100
500107,0,0,0,0,0,0,0,0,0,0,0,0,0,0,0,0,0,0,0,0,0,0,0,0,0,0,0,0,0,0,0,0,0,0,0
422111,17,12,0.71,5,0.29,0,0,17,100,0,0,0,0,0,0,17,100,0,0,17,1,0,0,0,0,17,100,9,0.53,8,0.47,0,0,17,100
783124,0,0,0,0,0,0,0,0,0,0,0,0,0,0,0,0,0,0,0,0,0,0,0,0,0,0,0,0,0,0,0,0,0,0,0
440022,3,2,0.67,1,0.33,0,0,3,100,0,0,0,0,0,0,3,100,1,0.33,2,0.67,0,0,0,0,3,100,0,0,3,1,0,0,3,100
500107,0,0,0,0,0,0,0,0,0,0,0,0,0,0,0,0,0,0,0,0,0,0,0,0,0,0,0,0,0,0,0,0,0,0,0
422111,0,0,0,0,0,0,0,0,0,0,0,0,0,0,0,0,0,0,0,0,0,0,0,0,0,0,0,0,0,0,0,0,0,0,0
783124,0,0,0,0,0,0,0,0,0,0,0,0,0,0,0,0,0,0,0,0,0,0,0,0,0,0,0,0,0,0,0,0,0,0,0
440022,1,1,1,0,0,0,0,1,100,0,0,0,0,0,0,1,100,0,0,1,1,0,0,0,0,1,100,0,0,1,1,0,0,1,100
641043,7,5,0.71,2,0.29,0,0,7,100,0,0,0,0,0,0,7,100,0,0,7,1,0,0,0,0,7,100,5,0.71,2,0.29,0,0,7,100
620020,4,4,1,0,0,0,0,4,100,0,0,0,0,1,0.25,4,100,0,0,4,1,0,0,0,0,4,100,1,0.25,3,0.75,0,0,4,100
422111,27,17,0.63,10,0.37,0,0,27,100,0,0,1,0.04,0,0,27,100,3,0.11,24,0.89,0,0,0,0,27,100,8,0.3,19,0.7,0,0,27,100
783124,0,0,0,0,0,0,0,0,0,0,0,0,0,0,0,0,0,0,0,0,0,0,0,0,0,0,0,0,0,0,0,0,0,0,0
440022,7,4,0.57,3,0.43,0,0,7,100,0,0,1,0.14,0,0,7,99,1,0.14,6,0.86,0,0,0,0,7,100,1,0.14,6,0.86,0,0,7,100
641043,0,0,0,0,0,0,0,0,0,0,0,0,0,0,0,0,0,0,0,0,0,0,0,0,0,0,0,0,0,0,0,0,0,0,0
620020,20,13,0.65,7,0.35,0,0,20,100,0,0,1,0.05,0,0,20,100,0,0,20,1,0,0,0,0,20,100,8,0.4,12,0.6,0,0,20,100
303101,0,0,0,0,0,0,0,0,0,0,0,0,0,0,0,0,0,0,0,0,0,0,0,0,0,0,0,0,0,0,0,0,0,0,0
457779,0,0,0,0,0,0,0,0,0,0,0,0,0,0,0,0,0,0,0,0,0,0,0,0,0,0,0,0,0,0,0,0,0,0,0
500107,13,4,0.31,9,0.69,0,0,13,100,0,0,1,0.08,0,0,13,100,1,0.08,12,0.92,0,0,0,0,13,100,5,0.38,8,0.62,0,0,13,100
422111,0,0,0,0,0,0,0,0,0,0,0,0,0,0,0,0,0,0,0,0,0,0,0,0,0,0,0,0,0,0,0,0,0,0,0
783124,0,0,0,0,0,0,0,0,0,0,0,0,0,0,0,0,0,0,0,0,0,0,0,0,0,0,0,0,0,0,0,0,0,0,0
440022,0,0,0,0,0,0,0,0,0,0,0,0,0,0,0,0,0,0,0,0,0,0,0,0,0,0,0,0,0,0,0,0,0,0,0
500107,2,2,1,0,0,0,0,2,100,0,0,0,0,0,0,2,100,0,0,2,1,0,0,0,0,2,100,2,1,0,0,0,0,2,100
422111,0,0,0,0,0,0,0,0,0,0,0,0,0,0,0,0,0,0,0,0,0,0,0,0,0,0,0,0,0,0,0,0,0,0,0
457779,16,11,0.69,5,0.31,0,0,16,100,0,0,0,0,0,0,16,100,1,0.06,15,0.94,0,0,0,0,16,100,3,0.19,13,0.81,0,0,16,100
500107,0,0,0,0,0,0,0,0,0,0,0,0,0,0,0,0,0,0,0,0,0,0,0,0,0,0,0,0,0,0,0,0,0,0,0
422111,5,4,0.8,1,0.2,0,0,5,100,0,0,0,0,0,0,5,100,0,0,5,1,0,0,0,0,5,100,2,0.4,3,0.6,0,0,5,100
783124,0,0,0,0,0,0,0,0,0,0,0,0,0,0,0,0,0,0,0,0,0,0,0,0,0,0,0,0,0,0,0,0,0,0,0
440022,0,0,0,0,0,0,0,0,0,0,0,0,0,0,0,0,0,0,0,0,0,0,0,0,0,0,0,0,0,0,0,0,0,0,0
641043,0,0,0,0,0,0,0,0,0,0,0,0,0,0,0,0,0,0,0,0,0,0,0,0,0,0,0,0,0,0,0,0,0,0,0
620020,0,0,0,0,0,0,0,0,0,0,0,0,0,0,0,0,0,0,0,0,0,0,0,0,0,0,0,0,0,0,0,0,0,0,0
303101,0,0,0,0,0,0,0,0,0,0,0,0,0,0,0,0,0,0,0,0,0,0,0,0,0,0,0,0,0,0,0,0,0,0,0
457779,0,0,0,0,0,0,0,0,0,0,0,0,0,0,0,0,0,0,0,0,0,0,0,0,0,0,0,0,0,0,0,0,0,0,0
500107,0,0,0,0,0,0,0,0,0,0,0,0,0,0,0,0,0,0,0,0,0,0,0,0,0,0,0,0,0,0,0,0,0,0,0
422111,0,0,0,0,0,0,0,0,0,0,0,0,0,0,0,0,0,0,0,0,0,0,0,0,0,0,0,0,0,0,0,0,0,0,0
783124,0,0,0,0,0,0,0,0,0,0,0,0,0,0,0,0,0,0,0,0,0,0,0,0,0,0,0,0,0,0,0,0,0,0,0
440022,0,0,0,0,0,0,0,0,0,0,0,0,0,0,0,0,0,0,0,0,0,0,0,0,0,0,0,0,0,0,0,0,0,0,0
500107,0,0,0,0,0,0,0,0,0,0,0,0,0,0,0,0,0,0,0,0,0,0,0,0,0,0,0,0,0,0,0,0,0,0,0
422111,0,0,0,0,0,0,0,0,0,0,0,0,0,0,0,0,0,0,0,0,0,0,0,0,0,0,0,0,0,0,0,0,0,0,0
783124,0,0,0,0,0,0,0,0,0,0,0,0,0,0,0,0,0,0,0,0,0,0,0,0,0,0,0,0,0,0,0,0,0,0,0
440022,0,0,0,0,0,0,0,0,0,0,0,0,0,0,0,0,0,0,0,0,0,0,0,0,0,0,0,0,0,0,0,0,0,0,0
641043,1,0,0,1,1,0,0,1,100,0,0,0,0,0,0,1,100,0,0,1,1,0,0,0,0,1,100,0,0,1,1,0,0,1,100
620020,0,0,0,0,0,0,0,0,0,0,0,0,0,0,0,0,0,0,0,0,0,0,0,0,0,0,0,0,0,0,0,0,0,0,0
422111,0,0,0,0,0,0,0,0,0,0,0,0,0,0,0,0,0,0,0,0,0,0,0,0,0,0,0,0,0,0,0,0,0,0,0
783124,0,0,0,0,0,0,0,0,0,0,0,0,0,0,0,0,0,0,0,0,0,0,0,0,0,0,0,0,0,0,0,0,0,0,0
440022,0,0,0,0,0,0,0,0,0,0,0,0,0,0,0,0,0,0,0,0,0,0,0,0,0,0,0,0,0,0,0,0,0,0,0
641043,0,0,0,0,0,0,0,0,0,0,0,0,0,0,0,0,0,0,0,0,0,0,0,0,0,0,0,0,0,0,0,0,0,0,0
641043,41,21,0.51,20,0.49,0,0,41,100,0,0,2,0.05,1,0.02,41,100,3,0.07,38,0.93,0,0,0,0,41,100,12,0.29,29,0.71,0,0,41,100
620020,17,12,0.71,5,0.29,0,0,17,100,0,0,1,0.06,1,0.06,17,100,0,0,17,1,0,0,0,0,17,100,3,0.18,14,0.82,0,0,17,100
303101,14,7,0.5,7,0.5,0,0,14,100,0,0,0,0,0,0,14,100,2,0.14,12,0.86,0,0,0,0,14,100,8,0.57,6,0.43,0,0,14,100
457779,18,8,0.44,10,0.56,0,0,18,100,0,0,0,0,0,0,18,100,1,0.06,17,0.94,0,0,0,0,18,100,8,0.44,10,0.56,0,0,18,100
500107,27,17,0.63,10,0.37,0,0,27,100,0,0,2,0.07,0,0,27,100,1,0.04,25,0.93,1,0.04,0,0,27,100,7,0.26,20,0.74,0,0,27,100
422111,5,3,0.6,2,0.4,0,0,5,100,0,0,1,0.2,0,0,5,100,0,0,5,1,0,0,0,0,5,100,1,0.2,4,0.8,0,0,5,100
783124,0,0,0,0,0,0,0,0,0,0,0,0,0,0,0,0,0,0,0,0,0,0,0,0,0,0,0,0,0,0,0,0,0,0,0
440022,52,25,0.48,27,0.52,0,0,52,100,0,0,3,0.06,1,0.02,52,100,3,0.06,48,0.92,1,0.02,0,0,52,100,19,0.37,33,0.63,0,0,52,100
641043,7,5,0.71,2,0.29,0,0,7,100,0,0,0,0,0,0,7,100,2,0.29,5,0.71,0,0,0,0,7,100,3,0.43,4,0.57,0,0,7,100
620020,27,20,0.74,7,0.26,0,0,27,100,0,0,2,0.07,0,0,27,100,2,0.07,25,0.93,0,0,0,0,27,100,14,0.52,13,0.48,0,0,27,100
303101,49,26,0.53,23,0.47,0,0,49,100,1,0.02,5,0.1,1,0.02,49,100,1,0.02,48,0.98,0,0,0,0,49,100,21,0.43,28,0.57,0,0,49,100
457779,3,2,0.67,1,0.33,0,0,3,100,0,0,0,0,0,0,3,100,0,0,2,0.67,1,0.33,0,0,3,100,3,1,0,0,0,0,3,100
500107,59,33,0.56,26,0.44,0,0,59,100,0,0,3,0.05,0,0,59,100,3,0.05,54,0.92,2,0.03,0,0,59,100,20,0.34,39,0.66,0,0,59,100
422111,15,7,0.47,8,0.53,0,0,15,100,0,0,0,0,0,0,15,100,0,0,15,1,0,0,0,0,15,100,7,0.47,8,0.53,0,0,15,100
783124,21,17,0.81,4,0.19,0,0,21,100,0,0,0,0,0,0,21,100,1,0.05,20,0.95,0,0,0,0,21,100,5,0.24,16,0.76,0,0,21,100
440022,65,39,0.6,26,0.4,0,0,65,100,1,0.02,0,0,0,0,65,100,3,0.05,62,0.95,0,0,0,0,65,100,17,0.26,48,0.74,0,0,65,100
500107,106,65,0.61,41,0.39,0,0,106,100,0,0,2,0.02,0,0,106,100,10,0.09,94,0.89,2,0.02,0,0,106,100,33,0.31,73,0.69,0,0,106,100
422111,81,46,0.57,35,0.43,0,0,81,100,0,0,7,0.09,0,0,81,100,2,0.02,79,0.98,0,0,0,0,81,100,23,0.28,58,0.72,0,0,81,100
783124,10,7,0.7,3,0.3,0,0,10,100,0,0,0,0,0,0,10,100,2,0.2,8,0.8,0,0,0,0,10,100,4,0.4,6,0.6,0,0,10,100
440022,43,24,0.56,19,0.44,0,0,43,100,0,0,1,0.02,0,0,43,100,2,0.05,41,0.95,0,0,0,0,43,100,17,0.4,26,0.6,0,0,43,100
641043,0,0,0,0,0,0,0,0,0,0,0,0,0,0,0,0,0,0,0,0,0,0,0,0,0,0,0,0,0,0,0,0,0,0,0
620020,0,0,0,0,0,0,0,0,0,0,0,0,0,0,0,0,0,0,0,0,0,0,0,0,0,0,0,0,0,0,0,0,0,0,0
422111,0,0,0,0,0,0,0,0,0,0,0,0,0,0,0,0,0,0,0,0,0,0,0,0,0,0,0,0,0,0,0,0,0,0,0
783124,20,12,0.6,8,0.4,0,0,20,100,0,0,0,0,0,0,20,100,2,0.1,18,0.9,0,0,0,0,20,100,8,0.4,12,0.6,0,0,20,100
440022,0,0,0,0,0,0,0,0,0,0,0,0,0,0,0,0,0,0,0,0,0,0,0,0,0,0,0,0,0,0,0,0,0,0,0
641043,0,0,0,0,0,0,0,0,0,0,0,0,0,0,0,0,0,0,0,0,0,0,0,0,0,0,0,0,0,0,0,0,0,0,0
620020,0,0,0,0,0,0,0,0,0,0,0,0,0,0,0,0,0,0,0,0,0,0,0,0,0,0,0,0,0,0,0,0,0,0,0
303101,0,0,0,0,0,0,0,0,0,0,0,0,0,0,0,0,0,0,0,0,0,0,0,0,0,0,0,0,0,0,0,0,0,0,0
457779,0,0,0,0,0,0,0,0,0,0,0,0,0,0,0,0,0,0,0,0,0,0,0,0,0,0,0,0,0,0,0,0,0,0,0
500107,0,0,0,0,0,0,0,0,0,0,0,0,0,0,0,0,0,0,0,0,0,0,0,0,0,0,0,0,0,0,0,0,0,0,0
422111,0,0,0,0,0,0,0,0,0,0,0,0,0,0,0,0,0,0,0,0,0,0,0,0,0,0,0,0,0,0,0,0,0,0,0
783124,0,0,0,0,0,0,0,0,0,0,0,0,0,0,0,0,0,0,0,0,0,0,0,0,0,0,0,0,0,0,0,0,0,0,0
440022,0,0,0,0,0,0,0,0,0,0,0,0,0,0,0,0,0,0,0,0,0,0,0,0,0,0,0,0,0,0,0,0,0,0,0
500107,0,0,0,0,0,0,0,0,0,0,0,0,0,0,0,0,0,0,0,0,0,0,0,0,0,0,0,0,0,0,0,0,0,0,0
422111,0,0,0,0,0,0,0,0,0,0,0,0,0,0,0,0,0,0,0,0,0,0,0,0,0,0,0,0,0,0,0,0,0,0,0
457779,0,0,0,0,0,0,0,0,0,0,0,0,0,0,0,0,0,0,0,0,0,0,0,0,0,0,0,0,0,0,0,0,0,0,0
500107,1,0,0,1,1,0,0,1,100,0,0,0,0,0,0,1,100,0,0,1,1,0,0,0,0,1,100,0,0,1,1,0,0,1,100
422111,0,0,0,0,0,0,0,0,0,0,0,0,0,0,0,0,0,0,0,0,0,0,0,0,0,0,0,0,0,0,0,0,0,0,0
783124,0,0,0,0,0,0,0,0,0,0,0,0,0,0,0,0,0,0,0,0,0,0,0,0,0,0,0,0,0,0,0,0,0,0,0
440022,0,0,0,0,0,0,0,0,0,0,0,0,0,0,0,0,0,0,0,0,0,0,0,0,0,0,0,0,0,0,0,0,0,0,0
641043,0,0,0,0,0,0,0,0,0,0,0,0,0,0,0,0,0,0,0,0,0,0,0,0,0,0,0,0,0,0,0,0,0,0,0
620020,0,0,0,0,0,0,0,0,0,0,0,0,0,0,0,0,0,0,0,0,0,0,0,0,0,0,0,0,0,0,0,0,0,0,0
303101,0,0,0,0,0,0,0,0,0,0,0,0,0,0,0,0,0,0,0,0,0,0,0,0,0,0,0,0,0,0,0,0,0,0,0
457779,0,0,0,0,0,0,0,0,0,0,0,0,0,0,0,0,0,0,0,0,0,0,0,0,0,0,0,0,0,0,0,0,0,0,0
500107,11,6,0.55,5,0.45,0,0,11,100,0,0,2,0.18,0,0,11,99,0,0,11,1,0,0,0,0,11,100,2,0.18,9,0.82,0,0,11,100
422111,0,0,0,0,0,0,0,0,0,0,0,0,0,0,0,0,0,0,0,0,0,0,0,0,0,0,0,0,0,0,0,0,0,0,0
783124,15,12,0.8,3,0.2,0,0,15,100,0,0,2,0.13,0,0,15,99,1,0.07,14,0.93,0,0,0,0,15,100,1,0.07,14,0.93,0,0,15,100
440022,37,17,0.46,20,0.54,0,0,37,100,0,0,1,0.03,0,0,37,100,1,0.03,36,0.97,0,0,0,0,37,100,19,0.51,18,0.49,0,0,37,100
500107,5,5,1,0,0,0,0,5,100,0,0,1,0.2,0,0,5,100,0,0,5,1,0,0,0,0,5,100,3,0.6,2,0.4,0,0,5,100
422111,13,3,0.23,10,0.77,0,0,13,100,0,0,0,0,0,0,13,100,0,0,13,1,0,0,0,0,13,100,9,0.69,4,0.31,0,0,13,100
783124,0,0,0,0,0,0,0,0,0,0,0,0,0,0,0,0,0,0,0,0,0,0,0,0,0,0,0,0,0,0,0,0,0,0,0
440022,0,0,0,0,0,0,0,0,0,0,0,0,0,0,0,0,0,0,0,0,0,0,0,0,0,0,0,0,0,0,0,0,0,0,0
641043,0,0,0,0,0,0,0,0,0,0,0,0,0,0,0,0,0,0,0,0,0,0,0,0,0,0,0,0,0,0,0,0,0,0,0
620020,36,12,0.33,24,0.67,0,0,36,100,0,0,3,0.08,0,0,36,100,0,0,36,1,0,0,0,0,36,100,11,0.31,25,0.69,0,0,36,100
422111,34,31,0.91,3,0.09,0,0,34,100,0,0,2,0.06,0,0,34,100,0,0,34,1,0,0,0,0,34,100,22,0.65,12,0.35,0,0,34,100
783124,10,8,0.8,2,0.2,0,0,10,100,0,0,1,0.1,0,0,10,100,1,0.1,9,0.9,0,0,0,0,10,100,0,0,10,1,0,0,10,100
440022,38,17,0.45,21,0.55,0,0,38,100,0,0,6,0.16,0,0,38,100,1,0.03,37,0.97,0,0,0,0,38,100,10,0.26,28,0.74,0,0,38,100
641043,10,7,0.7,3,0.3,0,0,10,100,0,0,0,0,0,0,10,100,0,0,10,1,0,0,0,0,10,100,2,0.2,8,0.8,0,0,10,100
424411,0,0,0,0,0,0,0,0,0,0,0,0,0,0,0,0,0,0,0,0,0,0,0,0,0,0,0,0,0,0,0,0,0,0,0
325522,0,0,0,0,0,0,0,0,0,0,0,0,0,0,0,0,0,0,0,0,0,0,0,0,0,0,0,0,0,0,0,0,0,0,0
641043,0,0,0,0,0,0,0,0,0,0,0,0,0,0,0,0,0,0,0,0,0,0,0,0,0,0,0,0,0,0,0,0,0,0,0
620020,111,97,0.87,14,0.13,0,0,111,100,0,0,6,0.05,0,0,111,100,8,0.07,102,0.92,1,0.01,0,0,111,100,51,0.46,60,0.54,0,0,111,100
303101,214,182,0.85,32,0.15,0,0,214,100,0,0,6,0.03,1,0,214,99,2,0.01,212,0.99,0,0,0,0,214,100,112,0.52,102,0.48,0,0,214,100
457779,8,1,0.13,7,0.88,0,0,8,100,0,0,1,0.13,0,0,8,100,0,0,8,1,0,0,0,0,8,100,5,0.63,3,0.38,0,0,8,100
500107,0,0,0,0,0,0,0,0,0,0,0,0,0,0,0,0,0,0,0,0,0,0,0,0,0,0,0,0,0,0,0,0,0,0,0
422111,0,0,0,0,0,0,0,0,0,0,0,0,0,0,0,0,0,0,0,0,0,0,0,0,0,0,0,0,0,0,0,0,0,0,0
783124,109,53,0.49,56,0.51,0,0,109,100,0,0,5,0.05,0,0,109,100,6,0.06,102,0.94,1,0.01,0,0,109,100,20,0.18,89,0.82,0,0,109,100
440022,93,53,0.57,40,0.43,0,0,93,100,0,0,8,0.09,0,0,93,100,6,0.06,86,0.92,1,0.01,0,0,93,99,28,0.3,65,0.7,0,0,93,100
641043,52,52,1,0,0,0,0,52,100,0,0,0,0,0,0,52,100,0,0,52,1,0,0,0,0,52,100,22,0.42,30,0.58,0,0,52,100
620020,10,7,0.7,3,0.3,0,0,10,100,0,0,0,0,0,0,10,100,0,0,10,1,0,0,0,0,10,100,4,0.4,6,0.6,0,0,10,100
303101,0,0,0,0,0,0,0,0,0,0,0,0,0,0,0,0,0,0,0,0,0,0,0,0,0,0,0,0,0,0,0,0,0,0,0
457779,52,32,0.62,20,0.38,0,0,52,100,0,0,3,0.06,1,0.02,52,100,3,0.06,49,0.94,0,0,0,0,52,100,5,0.1,47,0.9,0,0,52,100
500107,248,194,0.78,54,0.22,0,0,248,100,0,0,17,0.07,5,0.02,248,100,3,0.01,245,0.99,0,0,0,0,248,100,42,0.17,206,0.83,0,0,248,100
422111,0,0,0,0,0,0,0,0,0,0,0,0,0,0,0,0,0,0,0,0,0,0,0,0,0,0,0,0,0,0,0,0,0,0,0
783124,0,0,0,0,0,0,0,0,0,0,0,0,0,0,0,0,0,0,0,0,0,0,0,0,0,0,0,0,0,0,0,0,0,0,0
440022,14,6,0.43,8,0.57,0,0,14,100,0,0,1,0.07,0,0,14,100,0,0,14,1,0,0,0,0,14,100,5,0.36,9,0.64,0,0,14,100
500107,59,29,0.49,30,0.51,0,0,59,100,0,0,4,0.07,0,0,59,100,1,0.02,58,0.98,0,0,0,0,59,100,2,0.03,57,0.97,0,0,59,100
422111,50,17,0.34,33,0.66,0,0,50,100,0,0,1,0.02,0,0,50,100,1,0.02,48,0.96,1,0.02,0,0,50,100,4,0.08,46,0.92,0,0,50,100
783124,7,3,0.43,4,0.57,0,0,7,100,0,0,0,0,1,0.14,7,99,2,0.29,5,0.71,0,0,0,0,7,100,0,0,7,1,0,0,7,100
440022,0,0,0,0,0,0,0,0,0,0,0,0,0,0,0,0,0,0,0,0,0,0,0,0,0,0,0,0,0,0,0,0,0,0,0
641043,0,0,0,0,0,0,0,0,0,0,0,0,0,0,0,0,0,0,0,0,0,0,0,0,0,0,0,0,0,0,0,0,0,0,0
620020,0,0,0,0,0,0,0,0,0,0,0,0,0,0,0,0,0,0,0,0,0,0,0,0,0,0,0,0,0,0,0,0,0,0,0
422111,0,0,0,0,0,0,0,0,0,0,0,0,0,0,0,0,0,0,0,0,0,0,0,0,0,0,0,0,0,0,0,0,0,0,0
783124,2,1,0.5,1,0.5,0,0,2,100,0,0,1,0.5,0,0,2,100,2,1,0,0,0,0,0,0,2,100,0,0,2,1,0,0,2,100
440022,0,0,0,0,0,0,0,0,0,0,0,0,0,0,0,0,0,0,0,0,0,0,0,0,0,0,0,0,0,0,0,0,0,0,0
641043,0,0,0,0,0,0,0,0,0,0,0,0,0,0,0,0,0,0,0,0,0,0,0,0,0,0,0,0,0,0,0,0,0,0,0
620020,0,0,0,0,0,0,0,0,0,0,0,0,0,0,0,0,0,0,0,0,0,0,0,0,0,0,0,0,0,0,0,0,0,0,0
303101,0,0,0,0,0,0,0,0,0,0,0,0,0,0,0,0,0,0,0,0,0,0,0,0,0,0,0,0,0,0,0,0,0,0,0
457779,0,0,0,0,0,0,0,0,0,0,0,0,0,0,0,0,0,0,0,0,0,0,0,0,0,0,0,0,0,0,0,0,0,0,0
500107,0,0,0,0,0,0,0,0,0,0,0,0,0,0,0,0,0,0,0,0,0,0,0,0,0,0,0,0,0,0,0,0,0,0,0
422111,0,0,0,0,0,0,0,0,0,0,0,0,0,0,0,0,0,0,0,0,0,0,0,0,0,0,0,0,0,0,0,0,0,0,0
783124,0,0,0,0,0,0,0,0,0,0,0,0,0,0,0,0,0,0,0,0,0,0,0,0,0,0,0,0,0,0,0,0,0,0,0
440022,0,0,0,0,0,0,0,0,0,0,0,0,0,0,0,0,0,0,0,0,0,0,0,0,0,0,0,0,0,0,0,0,0,0,0
500107,0,0,0,0,0,0,0,0,0,0,0,0,0,0,0,0,0,0,0,0,0,0,0,0,0,0,0,0,0,0,0,0,0,0,0
422111,0,0,0,0,0,0,0,0,0,0,0,0,0,0,0,0,0,0,0,0,0,0,0,0,0,0,0,0,0,0,0,0,0,0,0
457779,5,4,0.8,1,0.2,0,0,5,100,0,0,0,0,0,0,5,100,1,0.2,4,0.8,0,0,0,0,5,100,0,0,5,1,0,0,5,100
500107,0,0,0,0,0,0,0,0,0,0,0,0,0,0,0,0,0,0,0,0,0,0,0,0,0,0,0,0,0,0,0,0,0,0,0
422111,0,0,0,0,0,0,0,0,0,0,0,0,0,0,0,0,0,0,0,0,0,0,0,0,0,0,0,0,0,0,0,0,0,0,0
783124,0,0,0,0,0,0,0,0,0,0,0,0,0,0,0,0,0,0,0,0,0,0,0,0,0,0,0,0,0,0,0,0,0,0,0
440022,2,1,0.5,1,0.5,0,0,2,100,0,0,0,0,0,0,2,100,0,0,2,1,0,0,0,0,2,100,1,0.5,1,0.5,0,0,2,100
641043,3,3,1,0,0,0,0,3,100,0,0,0,0,0,0,3,100,0,0,3,1,0,0,0,0,3,100,1,0.33,2,0.67,0,0,3,100
620020,2,0,0,2,1,0,0,2,100,0,0,0,0,0,0,2,100,0,0,2,1,0,0,0,0,2,100,0,0,2,1,0,0,2,100
303101,5,2,0.4,3,0.6,0,0,5,100,0,0,0,0,0,0,5,100,0,0,5,1,0,0,0,0,5,100,1,0.2,4,0.8,0,0,5,100
457779,0,0,0,0,0,0,0,0,0,0,0,0,0,0,0,0,0,0,0,0,0,0,0,0,0,0,0,0,0,0,0,0,0,0,0
500107,0,0,0,0,0,0,0,0,0,0,0,0,0,0,0,0,0,0,0,0,0,0,0,0,0,0,0,0,0,0,0,0,0,0,0
422111,0,0,0,0,0,0,0,0,0,0,0,0,0,0,0,0,0,0,0,0,0,0,0,0,0,0,0,0,0,0,0,0,0,0,0
783124,0,0,0,0,0,0,0,0,0,0,0,0,0,0,0,0,0,0,0,0,0,0,0,0,0,0,0,0,0,0,0,0,0,0,0
440022,0,0,0,0,0,0,0,0,0,0,0,0,0,0,0,0,0,0,0,0,0,0,0,0,0,0,0,0,0,0,0,0,0,0,0
500107,0,0,0,0,0,0,0,0,0,0,0,0,0,0,0,0,0,0,0,0,0,0,0,0,0,0,0,0,0,0,0,0,0,0,0
422111,0,0,0,0,0,0,0,0,0,0,0,0,0,0,0,0,0,0,0,0,0,0,0,0,0,0,0,0,0,0,0,0,0,0,0
783124,0,0,0,0,0,0,0,0,0,0,0,0,0,0,0,0,0,0,0,0,0,0,0,0,0,0,0,0,0,0,0,0,0,0,0
440022,11,6,0.55,5,0.45,0,0,11,100,0,0,0,0,0,0,11,100,1,0.09,10,0.91,0,0,0,0,11,100,5,0.45,6,0.55,0,0,11,100
641043,0,0,0,0,0,0,0,0,0,0,0,0,0,0,0,0,0,0,0,0,0,0,0,0,0,0,0,0,0,0,0,0,0,0,0
620020,0,0,0,0,0,0,0,0,0,0,0,0,0,0,0,0,0,0,0,0,0,0,0,0,0,0,0,0,0,0,0,0,0,0,0
422111,4,2,0.5,2,0.5,0,0,4,100,0,0,1,0.25,1,0.25,4,100,0,0,4,1,0,0,0,0,4,100,1,0.25,3,0.75,0,0,4,100
783124,1,0,0,1,1,0,0,1,100,0,0,0,0,0,0,1,100,0,0,1,1,0,0,0,0,1,100,0,0,1,1,0,0,1,100
440022,2,1,0.5,1,0.5,0,0,2,100,0,0,1,0.5,0,0,2,100,0,0,2,1,0,0,0,0,2,100,2,1,0,0,0,0,2,100
641043,0,0,0,0,0,0,0,0,0,0,0,0,0,0,0,0,0,0,0,0,0,0,0,0,0,0,0,0,0,0,0,0,0,0,0
641043,0,0,0,0,0,0,0,0,0,0,0,0,0,0,0,0,0,0,0,0,0,0,0,0,0,0,0,0,0,0,0,0,0,0,0
620020,0,0,0,0,0,0,0,0,0,0,0,0,0,0,0,0,0,0,0,0,0,0,0,0,0,0,0,0,0,0,0,0,0,0,0
303101,0,0,0,0,0,0,0,0,0,0,0,0,0,0,0,0,0,0,0,0,0,0,0,0,0,0,0,0,0,0,0,0,0,0,0
457779,0,0,0,0,0,0,0,0,0,0,0,0,0,0,0,0,0,0,0,0,0,0,0,0,0,0,0,0,0,0,0,0,0,0,0
500107,0,0,0,0,0,0,0,0,0,0,0,0,0,0,0,0,0,0,0,0,0,0,0,0,0,0,0,0,0,0,0,0,0,0,0
422111,2,0,0,2,1,0,0,2,100,0,0,0,0,0,0,2,100,1,0.5,1,0.5,0,0,0,0,2,100,0,0,2,1,0,0,2,100
783124,0,0,0,0,0,0,0,0,0,0,0,0,0,0,0,0,0,0,0,0,0,0,0,0,0,0,0,0,0,0,0,0,0,0,0
440022,0,0,0,0,0,0,0,0,0,0,0,0,0,0,0,0,0,0,0,0,0,0,0,0,0,0,0,0,0,0,0,0,0,0,0
641043,0,0,0,0,0,0,0,0,0,0,0,0,0,0,0,0,0,0,0,0,0,0,0,0,0,0,0,0,0,0,0,0,0,0,0
620020,0,0,0,0,0,0,0,0,0,0,0,0,0,0,0,0,0,0,0,0,0,0,0,0,0,0,0,0,0,0,0,0,0,0,0
303101,2,2,1,0,0,0,0,2,100,0,0,0,0,0,0,2,100,0,0,2,1,0,0,0,0,2,100,0,0,2,1,0,0,2,100
457779,0,0,0,0,0,0,0,0,0,0,0,0,0,0,0,0,0,0,0,0,0,0,0,0,0,0,0,0,0,0,0,0,0,0,0
500107,4,1,0.25,3,0.75,0,0,4,100,0,0,0,0,0,0,4,100,1,0.25,3,0.75,0,0,0,0,4,100,0,0,4,1,0,0,4,100
422111,0,0,0,0,0,0,0,0,0,0,0,0,0,0,0,0,0,0,0,0,0,0,0,0,0,0,0,0,0,0,0,0,0,0,0
783124,0,0,0,0,0,0,0,0,0,0,0,0,0,0,0,0,0,0,0,0,0,0,0,0,0,0,0,0,0,0,0,0,0,0,0
440022,0,0,0,0,0,0,0,0,0,0,0,0,0,0,0,0,0,0,0,0,0,0,0,0,0,0,0,0,0,0,0,0,0,0,0
500107,0,0,0,0,0,0,0,0,0,0,0,0,0,0,0,0,0,0,0,0,0,0,0,0,0,0,0,0,0,0,0,0,0,0,0
422111,0,0,0,0,0,0,0,0,0,0,0,0,0,0,0,0,0,0,0,0,0,0,0,0,0,0,0,0,0,0,0,0,0,0,0
783124,28,6,0.21,22,0.79,0,0,28,100,0,0,1,0.04,0,0,28,100,1,0.04,27,0.96,0,0,0,0,28,100,1,0.04,27,0.96,0,0,28,100
440022,0,0,0,0,0,0,0,0,0,0,0,0,0,0,0,0,0,0,0,0,0,0,0,0,0,0,0,0,0,0,0,0,0,0,0
641043,0,0,0,0,0,0,0,0,0,0,0,0,0,0,0,0,0,0,0,0,0,0,0,0,0,0,0,0,0,0,0,0,0,0,0
620020,0,0,0,0,0,0,0,0,0,0,0,0,0,0,0,0,0,0,0,0,0,0,0,0,0,0,0,0,0,0,0,0,0,0,0
422111,0,0,0,0,0,0,0,0,0,0,0,0,0,0,0,0,0,0,0,0,0,0,0,0,0,0,0,0,0,0,0,0,0,0,0
783124,0,0,0,0,0,0,0,0,0,0,0,0,0,0,0,0,0,0,0,0,0,0,0,0,0,0,0,0,0,0,0,0,0,0,0
440022,0,0,0,0,0,0,0,0,0,0,0,0,0,0,0,0,0,0,0,0,0,0,0,0,0,0,0,0,0,0,0,0,0,0,0
641043,37,12,0.32,25,0.68,0,0,37,100,0,0,0,0,0,0,37,100,0,0,37,1,0,0,0,0,37,100,3,0.08,34,0.92,0,0,37,100
620020,0,0,0,0,0,0,0,0,0,0,0,0,0,0,0,0,0,0,0,0,0,0,0,0,0,0,0,0,0,0,0,0,0,0,0
303101,0,0,0,0,0,0,0,0,0,0,0,0,0,0,0,0,0,0,0,0,0,0,0,0,0,0,0,0,0,0,0,0,0,0,0
457779,0,0,0,0,0,0,0,0,0,0,0,0,0,0,0,0,0,0,0,0,0,0,0,0,0,0,0,0,0,0,0,0,0,0,0
500107,0,0,0,0,0,0,0,0,0,0,0,0,0,0,0,0,0,0,0,0,0,0,0,0,0,0,0,0,0,0,0,0,0,0,0
422111,0,0,0,0,0,0,0,0,0,0,0,0,0,0,0,0,0,0,0,0,0,0,0,0,0,0,0,0,0,0,0,0,0,0,0
783124,5,3,0.6,2,0.4,0,0,5,100,0,0,0,0,0,0,5,100,0,0,5,1,0,0,0,0,5,100,0,0,5,1,0,0,5,100
440022,0,0,0,0,0,0,0,0,0,0,0,0,0,0,0,0,0,0,0,0,0,0,0,0,0,0,0,0,0,0,0,0,0,0,0
500107,21,1,0.05,20,0.95,0,0,21,100,0,0,1,0.05,1,0.05,21,100,0,0,21,1,0,0,0,0,21,100,5,0.24,16,0.76,0,0,21,100
422111,124,74,0.6,50,0.4,0,0,124,100,2,0.02,4,0.03,0,0,124,100,0,0,124,1,0,0,0,0,124,100,71,0.57,53,0.43,0,0,124,100
457779,55,5,0.09,50,0.91,0,0,55,100,0,0,5,0.09,0,0,55,100,0,0,55,1,0,0,0,0,55,100,19,0.35,36,0.65,0,0,55,100
500107,0,0,0,0,0,0,0,0,0,0,0,0,0,0,0,0,0,0,0,0,0,0,0,0,0,0,0,0,0,0,0,0,0,0,0
422111,44,44,1,0,0,0,0,44,100,0,0,0,0,0,0,44,100,0,0,44,1,0,0,0,0,44,100,35,0.8,9,0.2,0,0,44,100
783124,0,0,0,0,0,0,0,0,0,0,0,0,0,0,0,0,0,0,0,0,0,0,0,0,0,0,0,0,0,0,0,0,0,0,0
440022,52,2,0.04,50,0.96,0,0,52,100,0,0,6,0.12,0,0,52,100,1,0.02,51,0.98,0,0,0,0,52,100,21,0.4,31,0.6,0,0,52,100
641043,87,49,0.56,38,0.44,0,0,87,100,0,0,2,0.02,2,0.02,87,99,0,0,87,1,0,0,0,0,87,100,18,0.21,69,0.79,0,0,87,100
620020,13,6,0.46,7,0.54,0,0,13,100,0,0,0,0,0,0,13,100,0,0,13,1,0,0,0,0,13,100,2,0.15,11,0.85,0,0,13,100
303101,252,170,0.67,82,0.33,0,0,252,100,0,0,4,0.02,5,0.02,252,100,0,0,252,1,0,0,0,0,252,100,61,0.24,191,0.76,0,0,252,100
457779,35,34,0.97,1,0.03,0,0,35,100,0,0,0,0,0,0,35,100,2,0.06,33,0.94,0,0,0,0,35,100,20,0.57,15,0.43,0,0,35,100
500107,37,36,0.97,1,0.03,0,0,37,100,0,0,0,0,0,0,37,100,0,0,37,1,0,0,0,0,37,100,21,0.57,16,0.43,0,0,37,100
422111,7,2,0.29,5,0.71,0,0,7,100,0,0,0,0,0,0,7,100,0,0,7,1,0,0,0,0,7,100,2,0.29,5,0.71,0,0,7,100
783124,134,64,0.48,70,0.52,0,0,134,100,2,0.01,4,0.03,1,0.01,134,100,1,0.01,133,0.99,0,0,0,0,134,100,27,0.2,107,0.8,0,0,134,100
440022,82,50,0.61,32,0.39,0,0,82,100,0,0,6,0.07,0,0,82,100,0,0,82,1,0,0,0,0,82,100,24,0.29,58,0.71,0,0,82,100
500107,11,0,0,11,1,0,0,11,100,0,0,0,0,0,0,11,100,0,0,11,1,0,0,0,0,11,100,8,0.73,3,0.27,0,0,11,100
422111,11,11,1,0,0,0,0,11,100,0,0,0,0,0,0,11,100,0,0,11,1,0,0,0,0,11,100,8,0.73,3,0.27,0,0,11,100
783124,64,61,0.95,3,0.05,0,0,64,100,0,0,2,0.03,0,0,64,100,0,0,64,1,0,0,0,0,64,100,5,0.08,59,0.92,0,0,64,100
440022,63,1,0.02,62,0.98,0,0,63,100,0,0,1,0.02,1,0.02,63,100,0,0,63,1,0,0,0,0,63,100,23,0.37,40,0.63,0,0,63,100
641043,242,183,0.76,59,0.24,0,0,242,100,0,0,3,0.01,0,0,242,100,1,0,241,1,0,0,0,0,242,100,155,0.64,87,0.36,0,0,242,100
620020,201,66,0.33,135,0.67,0,0,201,100,0,0,3,0.01,1,0,201,99,4,0.02,197,0.98,0,0,0,0,201,100,77,0.38,124,0.62,0,0,201,100
422111,4,3,0.75,1,0.25,0,0,4,100,0,0,0,0,0,0,4,100,0,0,4,1,0,0,0,0,4,100,1,0.25,3,0.75,0,0,4,100
783124,83,39,0.47,44,0.53,0,0,83,100,0,0,2,0.02,0,0,83,100,0,0,83,1,0,0,0,0,83,100,35,0.42,48,0.58,0,0,83,100
440022,272,115,0.42,157,0.58,0,0,272,100,0,0,6,0.02,4,0.01,272,99,1,0,271,1,0,0,0,0,272,100,70,0.26,202,0.74,0,0,272,100
641043,17,2,0.12,15,0.88,0,0,17,100,0,0,2,0.12,0,0,17,100,0,0,17,1,0,0,0,0,17,100,7,0.41,10,0.59,0,0,17,100
424411,0,0,0,0,0,0,0,0,0,0,0,0,0,0,0,0,0,0,0,0,0,0,0,0,0,0,0,0,0,0,0,0,0,0,0
325522,0,0,0,0,0,0,0,0,0,0,0,0,0,0,0,0,0,0,0,0,0,0,0,0,0,0,0,0,0,0,0,0,0,0,0